111111111111111111111111111111111111111111
100000000000000C00000C00000000000010010001
101001010010000010100100000001010010010001
101001001010101000100100000001010010010001
1P0000000C00C0000000000000000000C010010001
100000000000000C00000C00000000000000000001
101001010010000010100100000001010010010001
101001001010101000100100000001010010010001
100000000C00C0000000000000000000C010010001
100000000000000C00000C00000000000010010001
101001010010000010100100000001010010010001
101001001010101000100100000001010010010001
100000000C00C0000000000000000000C010010001
100000000000000C00000C00000000000010010001
101001010010000010100100000001010010010001
101001001010101000100100000001010010010001
100000000C00C0000000000000000000C010010001
100000000000000C00000C00000000000010010001
101001010010000010100100000001010010010001
101001001010101000100100000001010010010001
100000000C00C0000000000000000000C010010001
100000000000000C00000C00000000000010010001
101001010010000010100100000001010010010001
101001001010101000100100000001010010010001
100000000C00C0000000000000000000C010010001
100000000000000C00000C0000000E000010010001
111111111111111111111111111111111111111111